##########
#P.....S.#
#...W....#
#...K....#
#...M....#
#...F...D#
##########