###########
#K...S...W#
#.###.###.#
#.#.....#.#
#M#..P..#F#
#.#.....#.#
#D#.....#S#
###########