##########
#P...#...#
#....#...#
#..K.#...#
#....#...#
#.......D#
##########